1111111111111111111111
1P00000000000000000001
1000000110111111111101
1000C00E10000000000001
1000C00010111111111111
10C0000010000000000011
1000000010111111111111
1000000010000000000001
1111111111111111111111
1111111111111111111111