11111
1P011
110C1
10001
110E1
11111