1111111111111111111111
1P0000000000C000000CC1
1000000011111111111101
1000C00010000000000001
1000C00010111111111111
10C0000010000000000011
1000C00010111111111111
1000C000100000000000E1
1111111111111111111111
1111111111111111111111